111111111111
1PCC00000XE1
111111111111
